C 0,0,0

NO ressources/textures/east.xpm
SO ressources/textures/east.xpm
WE ressources/textures/east.xpm
EA ressources/textures/east.xpm

F 0,0,0


111111111111111111111
1E0000001000000000011
101111101011111110111
101000101010000010101
101010101010111010101
101010101010101010101
101011101010101110101
101000000000000010001
101011111111111110101
101000100000000000101
101110101111111110101
100000101000000000001
111111101011111111111
100000000010000000001
111111111111111111111
