NO ressources/textures/east.xpm
SO ressources/textures/box.xpm
WE ressources/textures/stone_wall.xpm
EA ressources/textures/brick_wall.xpm

F 255,78,152
C 84,102,255

111111
100001
101001
101001
101001
101001
1010N1
100001
111111
