NO ressources/textures/north.xpm
SO ressources/textures/north.xpm
WE ressources/textures/plastic.xpm
EA ressources/textures/plastic.xpm

F 255,0,0
C 0,0,255

111111
100001
101001
101001
101001
101001
10100N
100001
111111
