NO ressources/textures/stone_wall.xpm
SO ressources/textures/stone_wall.xpm
WE ressources/textures/stone_wall.xpm
EA ressources/textures/stone_wall.xpm

F 255,0,0
C 0,0,255

        1111111111111111111111111
        1000000000110001111000001
        1011000001110001  1000001
111111111001000000000001111111001
111111111011000001110000000000001
100000000011000001110111111111111
11110111111111011100000010001
11110111111110101101010010001
11100000110101011100000010001           111
10100000000100001100000000001           1N1        
11100000000000001101010010001           111        
11000001110101011111011110001
11110111 1110101 101111010001
11111111 1111111 111111111111