NO textures/stone_wall.xpm
SO textures/stone_wall.xpm
WE textures/stone_wall.xpm
EA textures/stone_wall.xpm

F 255,0,0
C 0,0,255

        1111111111111111111111111
        1000000000110001111000001
        1011000001110001  1000001
        1001000000000001111111001
11111111101100N001110000000000001
100000000011000001110111111111111
11110111111111011100000010001
11110111111110101101010010001
11000000110101011100000010001
10000000000100001100000000001
10000000000000001101010010001
11000001110101011111011110001
11110111 1110101 101111010001
11111111 1111111 111111111111